@@@@@@@@@@@@@@@@@@@@@@@@@@@@@@@@@@@@@@@@@@@@@@@@@@@@@@@@@@@@@@@@@@@@@@@@@@@@@@@@@@@@@@@@@@@@@@@@@@@
@@@@@@@@@@@@@@@@@@@@@@@@@@@@@@@@@@@@@@@@@@==============^===@@@@@@@@@@@@@@@@@@@@@@@@@@@@@@@@@@@@@@@
@@@@@@@@@@@@@@@@@@@@@@@@@@@@@@@@@@@@@@@@@@=============/ \===@@@@@@@@@@@@@@@@@@@@@@@@@@@@@@@@@@@@@@
@@@@@@@@@@@@@@@@@@@@@@@@@@@@@@@@@@@@@@@@@@==============|===@==================================@@@@
@@@@=======@=====================@@@@@@@@@==============|===@==================================@@@@
@@@@=======@=====================@@@@@@@@@==================@==================================@@@@
@@@@======= =====================@@@@@@@@@@    @@@@@@@@@@@@@@==================================@@@@
@@@@======= =====================@==========================@==================================@@@@
@@@@=======@@@@@@@@@@   @@@@@@@@@@==========================@==================================@@@@
@@@@===|===@=====================@==========================@==================================@@@@
@@@@===|===@=====================@==========================@==================================@@@@
@@@@===|===@=====================@==========================@==================================@@@@
@@@@==\ /==@=====================@========================== ==================================@@@@
@@@@===V===@=====================@========================== ==================================@@@@
@@@@@@@@@@@@=====================@==========================@==================================@@@@
@@@@@@@@@@@@@@@@@@@@@@@@@@   @@@@@==========================@==================================@@@@
@@@@@@@@@@@====================== ==========================@==================================@@@@
@@@@@@@@@@@====================== ==========================@==================================@@@@
@@@@@@@@@@@======================@==========================@==================================@@@@
@@@@@@@@@@@======================@==========================@==================================@@@@
@@@@@@@@@@@======================@@@@@@@@   @@@@@@@@@@@@@@@@@@@@@@@@@@@    @@@@@@@@@@@@@@@@@@@@@@@@
@@@@@@@@@@@======================@====================@==================================@@@@@@@@@@
@@@@@@@@@@@======================@====================@==================================@@@@@@@@@@
@@@@@@@@@@@======================@====================@==================================@@@@@@@@@@
@@@@@@@@@@@======================@====================@==================================@@@@@@@@@@
@@@@@@@@@@@======================@====================@==================================@@@@@@@@@@
@@@@@@@@@@@======================@====================@==================================@@@@@@@@@@
@@@@@@@@@@@======================@====================@==================================@@@@@@@@@@
@@@@@@@@@@@======================@====================@==================================@@@@@@@@@@
@@@@@@@@@@@======================@====================@==================================@@@@@@@@@@
@@@@@@@@@@@======================@====================@==================================@@@@@@@@@@
@@@@@@@@@@@======================@====================@==================================@@@@@@@@@@
@@@@@@@@@@@@@@@@@@@@@@@@@@@@@@@@@@@@@@@@@@@@@@@@@@@@@@@==================================@@@@@@@@@@
@@@@@@@@@@@@@@@@@@@@@@@@@@@@@@@@@@@@@@@@@@@@@@@@@@@@@@@==================================@@@@@@@@@@
@@@@@@@@@@@@@@@@@@@@@@@@@@@@@@@@@@@@@@@@@@@@@@@@@@@@@@@@@@@@@@@@@@@@@@@@@@@@@@@@@@@@@@@@@@@@@@@@@@@

